1 1 1 1 1 1 1 1 1 1 1 1 1 1 1 1 1 1 1 1 1 1 1 1 1 1 1 1 1 1
7 9 0 0 0 0 0 0 0 0 2 0 4 0 2 0 0 0 0 0 0 0 0 0 0 0 0 0 8 1
7 0 0 0 0 1 1 0 3 0 0 0 2 0 0 0 0 0 0 0 0 0 0 0 0 0 0 0 0 1
1 0 0 1 1 1 1 1 1 1 1 6 6 6 1 1 1 1 1 1 0 1 1 1 1 1 1 0 0 1
1 0 0 0 1 1 1 1 6 6 6 6 1 1 1 1 1 1 1 1 3 1 1 1 1 1 1 0 0 1
1 0 0 0 0 0 0 0 0 6 6 1 1 1 1 1 1 1 1 1 1 1 1 1 1 1 1 0 0 1
1 3 0 0 0 0 0 0 0 0 2 0 0 5 0 0 0 4 0 0 0 0 0 2 0 0 0 0 4 1
1 0 0 0 0 0 0 0 2 0 0 0 0 0 0 9 0 0 0 0 0 0 0 0 0 0 2 0 0 1
1 0 4 1 1 1 1 1 1 1 1 1 1 4 0 1 1 1 1 1 1 1 1 1 1 1 1 2 0 1
1 0 0 1 1 1 1 1 1 1 1 6 6 0 0 1 1 1 1 5 1 1 1 1 1 1 1 0 0 1
1 0 0 1 1 1 1 1 1 1 1 6 1 1 1 1 1 1 6 0 6 1 1 1 1 1 1 0 3 1
1 4 0 0 0 0 3 0 0 0 2 0 0 0 4 0 0 0 0 0 2 2 0 0 0 0 0 0 0 1
1 0 0 0 0 0 0 0 4 0 0 0 0 0 0 0 0 0 0 0 0 0 0 0 2 0 0 0 0 1
1 1 1 1 1 6 6 1 1 1 6 6 1 1 1 1 1 1 1 1 1 1 1 1 1 1 1 0 0 1
1 1 1 1 1 1 1 1 1 1 1 1 1 1 1 1 1 1 1 1 1 1 1 1 1 1 1 0 3 1
1 1 1 1 1 1 1 1 1 1 1 1 1 1 1 1 1 1 1 1 1 1 1 1 1 1 1 1 1 1